{
    "width": 6,
    "height": 7,
    "_map": [
        "0 1 1 2 2 4",
        "1 2 3 3 4 4",
        "0 1 1 2 4 5",
        "1 0 1 3 3 5",
        "0 2 3 3 4 4",
        "1 1 2 4 3 5",
        "0 1 1 2 3 4"
    ]
}