{
    "width": 8,
    "height": 8,
    "_map": [
        "3 0 1 0 5 1 0 3",
        "0 5 0 3 0 4 4 2",
        "1 2 2 1 2 0 1 5",
        "0 1 0 3 0 3 4 5",
        "1 0 3 1 3 1 0 5",
        "0 2 0 4 0 5 4 2",
        "4 1 3 5 2 1 3 5",
        "0 5 0 4 0 0 2 5"
    ]
}